11111111111111111111111
1E00C00000C0000001M0001
100001010010CCC00010101
11010M010010010M0010101
1C00P000000000000000C11
11111111111111111111111


