111111111111
1000PPE00011
1111011111111
